  11111111
  12222111
  12322521
1112321121
1444232221
1444313211
1111212321
   1222221
   1111111