
00000000000000000000
00000001111111100000
00000001222211100000
00000001232252100000
00000111232112100000
00000144423222100000
00000144431321100000
00000111121232100000
00000000122222100000
00000000111111100000
00000000000000000000



//0
//1 墙
//2空格
//3箱子
//4指定地点
//hero