
00000000000000000000
00000000111111110000
00000000122214210000
00000001122344410000
00000001223212410000
00000011211312110000
00000012223223210000
00000012221222210000
00000011111115210000
00000000000011110000
00000000000000000000
