#######
#  .  #
# $@$ #
#  .  #
#######
